%%%%%%%%%%%%%%%%%%%%%%%
% .            .      %
%                     %
%   %%%%%         %   %
%P          .  G  %   %
%       %%%       % . %
%   %        %    %   %
%   %        %        %
%    .            .   %
%%%%%%%%%%%%%%%%%%%%%%%
